You may only use the types between []'s, failure to do so will cause errors.

NORMAL - [Normal]
FIRE - [Fire]
FIGHTING - [Fighting]
WATER - [Water]
FLYING - [Flying]
GRASS - [Grass]
POISON - [Poison]
ELECTRIC - [Electric]
GROUND - [Ground]
PSYCHIC - [Psychic]
ROCK - [Rock]
ICE - [Ice]
BUG - [Bug]
DRAGON - [Dragon]
GHOST - [Ghost]
DARK - [Dark]
STEEL - [Steel]
FAIRY - [Fairy]
TYPE_X - [Type X]
GEN1 - [Gen. 1 (Kanto)]
GEN2 - [Gen. 2 (Johto)]
GEN3 - [Gen. 3 (Hoenn)]
GEN4 - [Gen. 4 (Sinnoh)]
GEN5 - [Gen. 5 (Unova)]
GEN6 - [Gen. 6 (Kalos)]
GEN7 - [Gen. 7 (Alola)]
GEN8 - [Gen. 8 (Galar)]
GENX - [Gen. X (future)]
FAKEMON - [Fakemon]
PSEUDOLEGENDARY - [Pseudo-Legendary]
ULTRABEAST - [Ultra Beast]
SUBLEGENDARY - [Sub-Legendary]
LEGENDARY - [Legendary]
MYTHICAL - [Mythical]
ALOLAN - [Alolan form]
GALARIAN - [Galar form]
REGION_X - [Region X form]
PIKACHUCLONE - [Pikachu-Family]
FOSSIL - [Fossil]
STARTER - [Starter]
